#
# win32 specific fragment for building
#
# $Id: win32.txt,v 1.7 2012/01/24 22:15:43 jon Exp $
#
EXEEXT=	.exe
LIBEXT=	lib
OBJEXT=	obj
DEPENDOBJEXT=	o
DEPENDEXT=	d
ASMOUTEXT=	s
PPEXT=	e
CC=	cl
COMPILER=${CC}
DEPEND_CC=	gcc
REL_COMPILE_FLAGS=	/O2
DEBUG_COMPILE_FLAGS=	/Zi
ASMOUT_FLAGS=	-S
PP_FLAGS=	-E
REL_LINK_FLAGS=
DEBUG_LINK_FLAGS=	/DEBUG
PROF_COMPILE_FLAGS=
PROF_LINK_FLAGS=	/PROFILE $(DEBUG_LINK_FLAGS)
PROFNA_LINK_FLAGS=	$(PROF_LINK_FLAGS)
NA_COMPILE_FLAGS=	"/DNDEBUG=1"
LINK=	link /nologo /out:
ARCHIVE=	link /lib /nologo /out:
COMPILE_WARNINGS=	/W2 /WX
COMPILE_INCLUDES=	/FI$(ARCH)/mt_types.h
COMPILE_DEFINES+=	-DWIN32
COMPILE_CFLAGS=	$(COMPILE_INCLUDES) $(COMPILE_DEFINES) $(COMPILE_EXTRA_DEFS) $(COMPILE_WARNINGS)
COMPILE=	$(CC) /c /nologo /Fo
DEP_COMPILE_CFLAGS=	-MM -MG -include $(ARCH)/mt_types.h $(COMPILE_DEFINES) $(COMPILE_EXTRA_DEFS)
